NO 1.png
SO 2.png
WE 3.png
EA 4.png

F 220,100,0
C 225,30,0

        111111111111111111111111
        1000000000110000000000011
        1011000001110000010000001
        1001000000000000001000001
1111111110110000011100N0000000001
100000000011000001110111111111111
11110111111111011100000000001
11110111111111011101010010001
11000000110101011100000010001
10000000000000001100000010001
10000000000000001101010010001
110000011101010111110111100111
11110111 1110101 101111010001
11111111 1111111 111111111111

